WWWWWWWWWWWWWWWWWWWWWWWWWWW
WM WWW KPP  PM    MWWWW  MW
W W M DDDDWWWWWWW K DPP W W
W WWWDDWWWWPWPWPWW WW PPP W
W   M     WKDPW   K  PP M W
WWPPPWW WWW WPW W PPPDDDDPW
WK    D     WPW   D      KW
W WWPPW WWWWDDKWW W WWMWW W
W K   W PPPPMPPPP D     WKW
WJK D  PWWWWPPPPPP   M    W
WWWWWWWWWWWWWWWWWWWWWWWWWWW