WWWWWWWWWWWWWWWWWWWWWWWWWWW
WM WK KPP  DPK M  MWPWM  KW
W   K DDDDWWWPPPW K DPP W W
W PPPDDPKWWPWPWPWW WW PPP W
W   M     WKDPW   K  PP M W
WWW WPPP   DDWPW  PPP  D PW
WK    D     WPW   DPPPKP DW
W WWPPW WWKWDDKWW PPDWD  MW
W M   WKP PPMPPPP K    WWKW
WM DK  PW  WPPKPPPDD J PPPW
WWWWWWWWWWWWWWWWWWWWWWWWWWW